11111111111111111111111111111
1E0000000000000C00000C0000001
10100101001000001010010000001
1010010010101010V01001000V001
1P0000000C00C0000000000000001
11111111111111111111111111111